||||||||||||||||||||||||||||||||||||||||||||||||||||||||||||||||||||||||||||||||||||||||||||||||||||||||||||||||||||||||
||||||||||||||||||||||||||||||||||||||||||||||||||||||||||||||||||||||||||||||||||||||||||||||||||||||||||||||||||||||||
||||||||||||||||||||||||||||||||||||||||||||||||||||||||||||||||||||||||||||||||||||||||||||||||||||||||||||||||||||||||
||||||||||||||||||||||||||||||||||||||||||||||||||||||||||||||||||||||||||||||||||||||||||||||||||||||||||||||||||||||||
||||||||||||||||||||||||||||||||||||||||||||||||||||||||||||||||||||||||||||||||||||||||||||||||||||||||||||||||||||||||
||||||||||||||||||||||||||||||||||||||||||||||||||||||||||||||||||||||||||||||||||||||||||||||||||||||||||||||||||||||||
||||||||||.............||||||||||||||..............||||||||||||||..............||||||||||||||.............||||||||||||||
||||||||||.S...........||||||||||||||..AA..........||||||||||||||...........R..||||||||||||||......F......||||||||||||||
||||||||||.............||||||||||||||..............||||||||||||||..............||||||||||||||.............||||||||||||||
||||||||||.............||||||||||||||..............||||||||||||||..............||||||||||||||.............||||||||||||||
||||||||||..............................................................W.................................||||||||||||||
||||||||||..............................................................................R.................||||||||||||||
||||||||||..............................................................................R...............R.||||||||||||||
||||||||||................................................................................................||||||||||||||
||||||||||.............||||||||||||||..............||||||||||||||.......W......||||||||||||||.............||||||||||||||
||||||||||..F.......F..||||||||||||||..............||||||||||||||..............||||||||||||||.............||||||||||||||
||||||||||.............||||||||||||||.........HH...||||||||||||||..............||||||||||||||.............||||||||||||||
||||||||||.............||||||||||||||............S.||||||||||||||...........R..||||||||||||||......F......||||||||||||||
||||||||||.............||||||||||||||..............||||||||||||||..............||||||||||||||...........S.||||||||||||||
|||||||||||||||....|||||||||||||||||||||||||||||||||||||||||||||||||||||||||||||||||||||||||||||||||||||..||||||||||||||
|||||||||||||||....|||||||||||||||||||||||||||||||||||||||||||||||||||||||||||||||||||||||||||||||||||||..||||||||||||||
|||||||||||||||....|||||||||||||||||||||||||||||||||||||||||||||||||||||||||||||||||||||||||||||||||||||..||||||||||||||
|||||||||||||||....|||||||||||||||||||||||||||||||||||||||||||||||||||||||||||||||||||||||||||||||||||||..||||||||||||||
|||||||||||||||....|||||||||||||||||||||||||||||||||||||||||||||||||||||||||||||||||||||||||||||||||||||..||||||||||||||
|||||||||||||||....|||||||||||||||||||||||||||||||||||||||||||||||||||||||||||||||||||||||||||||||||||||..||||||||||||||
|||||||||||||||....|||||||||||||||||||||||||||||||||||||||||||||||||||||||||||||||||||||||||||||||||||||..||||||||||||||
|||||||||||||||....|||||||||||||||||||||||||||||||||||||||||||||||||||||||||||||||||||||||||||||||||||||..||||||||||||||
|||||||||||||||....|||||||||||||||||||||||||||||||||||||||||||||||||||||||||||||||||||||||||||||||||||||..||||||||||||||
|||||||||||||||....|||||||||||||||||||||||||||||||||||||||||||||||||||||||||||||||||||||||||||||||||||||..||||||||||||||
|||||||||||||||....|||||||||||||||||||||||||||||||||||||||||||||||||||||||||||||||||||||||||||||||||||||..||||||||||||||
|||||||||||||||....|||||||||||||||||||||||||||||||||||||||||||||||||||||||||||||||||||||||||||||||||||||..||||||||||||||
|||||||||||||||....|||||||||||||||||||||||||||||||||||||||||||||||||||||||||||||||||||||||||||||||||||||||||||||||||||||
|||||||||||||||....|||||||||||||||||||||||||||||||||||||||||||||||||||||||||||||||||||||||||||||||||||||||||||||||||||||
||||||||||.............||||||||||||||||||||||||||||||||||||||||||||||||||||||||||||||||||||||.............||||||||||||||
||||||||||.......A.....||||||||||||||||||||||||||||||||||||||||||||||||||||||||||||||||||||||.........A...||||||||||||||
||||||||||......W......||||||||||||||||||||||||||||||||||||||||||||||||||||||||||||||||||||||.............||||||||||||||
||||||||||......W......||||||||||||||||||||||||||||||||||||||||||||||||||||||||||||||||||||||.R...........||||||||||||||
||||||||||......W......||||||||||||||||||||||||||||||||||||||||||||||||||||||||||||||||||||||.R...........||||||||||||||
||||||||||..................................................................................|.R...........||||||||||||||
||||||||||......@.......................................................R...........S..F....|.R....#..........||||||||||
||||||||||......................................R...................................S.......|.R...............||||||||||
||||||||||..................................................................................|.R...........||FF||||||||||
||||||||||.............||||||||||||||||||||||||||||||||||||||||||||||||||||||||||||||||||||||.............||..||||||||||
||||||||||.............||||||||||||||||||||||||||||||||||||||||||||||||||||||||||||||||||||||.............||..||||||||||
||||||||||.............||||||||||||||||||||||||||||||||||||||||||||||||||||||||||||||||||||||.............||..||||||||||
||||||||||.............||||||||||||||||||||||||||||||||||||||||||||||||||||||||||||||||||||||.....H.......||..||||||||||
||||||||||.............||||||||||||||||||||||||||||||||||||||||||||||||||||||||||||||||||||||.............||..||||||||||
|||||||||||||||....|||||||||||||||||||||||||||||||||||||||||||||||||||||||||||||||||||||||||||||||||||||||||..||||||||||
|||||||||||||||....|||||||||||||||||||||||||||||||||||||||||||||||||||||||||||||||||||||||||||||||||||||||||..||||||||||
|||||||||||||||....|||||||||||||||||||||||||||||||||||||||||||||||||||||||||||||||||||||||||||||||||||||......||||||||||
|||||||||||||||....|||||||||||||||||||||||||||||||||||||||||||||||||||||||||||||||||||||||||||||||||||||..R...||||||||||
|||||||||||||||....|||||||||||||||||||||||||||||||||||||||||||||||||||||||||||||||||||||||||||||||||||||......||||||||||
|||||||||||||||....|||||||||||||||||||||||||||||||||||||||||||||||||||||||||||||||||||||||||||||||||||||..||||||||||||||
|||||||||||||||....|||||||||||||||||||||||||||||||||||||||||||||||||||||||||||||||||||||||||||||||||||||..||||||||||||||
|||||||||||||||....|||||||||||||||||||||||||||||||||||||||||||||||||||||||||||||||||||||||||||||||||||||..||||||||||||||
|||||||||||||||....|||||||||||||||||||||||||||||||||||||||||||||||||||||||||||||||||||||||||||||||||||||..||||||||||||||
|||||||||||||||....|||||||||||||||||||||||||||||||||||||||||||||||||||||||||||||||||||||||||||||||||||||..||||||||||||||
|||||||||||||||....|||||||||||||||||||||||||||||||||||||||||||||||||||||||||||||||||||||||||||||||||||||..||||||||||||||
|||||||||||||||....|||||||||||||||||||||||||||||||||||||||||||||||||||||||||||||||||||||||||||||||||||||..||||||||||||||
|||||||||||||||....|||||||||||||||||||||||||||||||||||||||||||||||||||||||||||||||||||||||||||||||||||||..||||||||||||||
|||||||||||||||....|||||||||||||||||||||||||||||||||||||||||||||||||||||||||||||||||||||||||||||||||||||..||||||||||||||
||||||||||.............||||||||||||||..............||||||||||||||..............||||||||||||||.............||||||||||||||
||||||||||.............||||||||||||||.F.........F..||||||||||||||...........S..||||||||||||||..S.R......S.||||||||||||||
||||||||||.............||||||||||||||..............||||||||||||||..............||||||||||||||.............||||||||||||||
||||||||||.............||||||||||||||..............||||||||||||||..............||||||||||||||.............||||||||||||||
||||||||||.............||||||||||||||..............||||||||||||||..............||||||||||||||.............||||||||||||||
||||||||||................................................................................................||||||||||||||
||||||||||......................................F..........H................S......................R......||||||||||||||
||||||||||................................................A...............................................||||||||||||||
||||||||||................................................................................................||||||||||||||
||||||||||.............||||||||||||||..............||||||||||||||..............||||||||||||||.............||||||||||||||
||||||||||.............||||||||||||||..............||||||||||||||..............||||||||||||||.............||||||||||||||
||||||||||..SF......A..||||||||||||||...........F..||||||||||||||...........S..||||||||||||||..F.......RF.||||||||||||||
||||||||||.............||||||||||||||..............||||||||||||||..............||||||||||||||.............||||||||||||||
||||||||||||||||||||||||||||||||||||||||||||||||||||||||||||||||||||||||||||||||||||||||||||||||||||||||||||||||||||||||
||||||||||||||||||||||||||||||||||||||||||||||||||||||||||||||||||||||||||||||||||||||||||||||||||||||||||||||||||||||||
||||||||||||||||||||||||||||||||||||||||||||||||||||||||||||||||||||||||||||||||||||||||||||||||||||||||||||||||||||||||
||||||||||||||||||||||||||||||||||||||||||||||||||||||||||||||||||||||||||||||||||||||||||||||||||||||||||||||||||||||||
||||||||||||||||||||||||||||||||||||||||||||||||||||||||||||||||||||||||||||||||||||||||||||||||||||||||||||||||||||||||
||||||||||||||||||||||||||||||||||||||||||||||||||||||||||||||||||||||||||||||||||||||||||||||||||||||||||||||||||||||||