||||||||||||||||||||||||||||||||||||||||||||||||||||||||||||||||||||||||||||||||||||||||
||||||||||||||||||||||||||||||||||||||||||||||||||||||||||||||||||||||||||||||||||||||||
||||||||||||||||||||||||||||||||||||||||||||||||||||||||||||||||||||||||||||||||||||||||
||||||||||||||||||||||||||||||||||||||||||||||||||||||||||||||||||||||||||||||||||||||||
||||||||||||||||||||||||||||||||||||||||||||||||||||||||||||||||||||||||||||||||||||||||
||||||||||||||||||||||||||||||||||||||||||||||||||||||||||||||||||||||||||||||||||||||||
||||||||||RRRRRRRRRRRRR||||||||||||||RRRRRRRRRRRRRR||||||||||||||RRRRRRRRRRRRR||||||||||
||||||||||RRRRRRRRRRRRR||||||||||||||RRRRRRRRRRRRRR||||||||||||||RRRRRRRRRRRRR||||||||||
||||||||||RRRRRRRRRRRRR||||||||||||||RRRRRRRRRRRRRR||||||||||||||RRRRRRRRRRRRR||||||||||
||||||||||RRRRRRRRRRRRR||||||||||||||RRRRRRRRRRRRRR||||||||||||||RRRRRRRRRRRRR||||||||||
||||||||||RRRRRRRRRRRRRRRRRRRRRRRRRRRRRRRRRRRRRRRRR||||||||||||||RRRRRRRRRRRRR||||||||||
||||||||||RRRRRRWRRRRRRRRRRRRRRRRRRRRRRRRRRRRRRRRRR||||||||||||||RRRRRRRRRRRRR||||||||||
||||||||||RRRRRRRRRRRRRRRRRRRRRRRRRRRRRRRRRRRRRRRRR||||||||||||||RRRRRR#RRRRRR||||||||||
||||||||||RRRRRRRRRRRRRRRRRRRRRRRRRRRRRRRRRRRRRRRRR||||||||||||||RRRRRRRRRRRRR||||||||||
||||||||||RRRRRRRRRRRRR||||||||||||||RRRRRRRRRRRRRR||||||||||||||RRRRRRRRRRRRR||||||||||
||||||||||RRRRRRRRRRRRR||||||||||||||RRRRRRRRRRRRRR||||||||||||||RRRRRRRRRRRRR||||||||||
||||||||||RRRRRRRRRRRRR||||||||||||||RRRRRRRRRRRRRR||||||||||||||RRRRRRRRRRRRR||||||||||
||||||||||RRRRRRRRRRRRR||||||||||||||RRRRRRRRRRRRRR||||||||||||||RRRRRRRRRRRRR||||||||||
||||||||||RRRRRRRRRRRRR||||||||||||||RRRRRRRRRRRRRR||||||||||||||RRRRRRRRRRRRR||||||||||
|||||||||||||||RRRR||||||||||||||||||||||||||||||||||||||||||||||||||RRRR|||||||||||||||
|||||||||||||||RRRR||||||||||||||||||||||||||||||||||||||||||||||||||RRRR|||||||||||||||
|||||||||||||||RRRR||||||||||||||||||||||||||||||||||||||||||||||||||RRRR|||||||||||||||
|||||||||||||||RRRR||||||||||||||||||||||||||||||||||||||||||||||||||RRRR|||||||||||||||
|||||||||||||||RRRR||||||||||||||||||||||||||||||||||||||||||||||||||RRRR|||||||||||||||
|||||||||||||||RRRR||||||||||||||||||||||||||||||||||||||||||||||||||RRRR|||||||||||||||
|||||||||||||||RRRR||||||||||||||||||||||||||||||||||||||||||||||||||RRRR|||||||||||||||
|||||||||||||||RRRR||||||||||||||||||||||||||||||||||||||||||||||||||RRRR|||||||||||||||
|||||||||||||||RRRR||||||||||||||||||||||||||||||||||||||||||||||||||RRRR|||||||||||||||
|||||||||||||||RRRR||||||||||||||||||||||||||||||||||||||||||||||||||RRRR|||||||||||||||
|||||||||||||||RRRR||||||||||||||||||||||||||||||||||||||||||||||||||RRRR|||||||||||||||
|||||||||||||||RRRR||||||||||||||||||||||||||||||||||||||||||||||||||RRRR|||||||||||||||
|||||||||||||||RRRR||||||||||||||||||||||||||||||||||||||||||||||||||RRRR|||||||||||||||
|||||||||||||||RRRR||||||||||||||||||||||||||||||||||||||||||||||||||RRRR|||||||||||||||
||||||||||RRRRRRRRRRRRR||||||||||||||RRRRRRRRRRRRRR||||||||||||||RRRRRRRRRRRRR||||||||||
||||||||||RRRRRRRRRRRRR||||||||||||||RRRRRRRRRRRRRR||||||||||||||RRRRRRRRRRRRR||||||||||
||||||||||RRRRRRRRRRRRR||||||||||||||RRRRSRRRRSRRRR||||||||||||||RRRRRRRRRRRRR||||||||||
||||||||||RRRRRRRRRRRRR||||||||||||||RRRRRRRRRRRRRR||||||||||||||RRRRRRRRRRRRR||||||||||
||||||||||RRRRRRRRRRRRR||||||||||||||RRRRRRRRRRRRRR||||||||||||||RRRRRRRRRRRRR||||||||||
||||||||||RRRRRRRRRRRRRRRRRRRRRRRRRRRRRRRRRRRRRRRRRRRRRRRRRRRRRRRRRRRRRRRRRRRR||||||||||
||||||||||RRRRRRRRRRRRRRRRRRRRRRRRRRRRRRRRRRFRRRRRRRRRRRRRRRRRRRRRRRRRRRRRRRRR||||||||||
||||||||||RRRRRRRRRRRRRRRRRRRRRRRRRRRRRRRRRRRRRRRRRRRRRRRRRRRRRRRRRRRRRRRRRRRR||||||||||
||||||||||RRRRRRRRRRRRRRRRRRRRRRRRRRRRRRRRRRRRRRRRRRRRRRRRRRRRRRRRRRRRRRRRRRRR||||||||||
||||||||||RRRRRRRRRRRRR||||||||||||||RRRRRRRRRRRRRR||||||||||||||RRRRRRRRRRRRR||||||||||
||||||||||RRRRRRRRRRRRR||||||||||||||RRRRRRRRRRRRRR||||||||||||||RRRRRRRRRRRRR||||||||||
||||||||||RRRRRRRRRRRRR||||||||||||||RRRRRRRRRRRRRR||||||||||||||RRRRRRRRRRRRR||||||||||
||||||||||RRRRRRRRRRRRR||||||||||||||RRRRRRRRRRRRRR||||||||||||||RRRRRRRRRRRRR||||||||||
||||||||||RRRRRRRRRRRRR||||||||||||||RRRRRRRRRRRRRR||||||||||||||RRRRRRRRRRRRR||||||||||
|||||||||||||||RRRR|||||||||||||||||||||||RRRR|||||||||||||||||||||||RRRR|||||||||||||||
|||||||||||||||RRRR|||||||||||||||||||||||RRRR|||||||||||||||||||||||RRRR|||||||||||||||
|||||||||||||||RRRR|||||||||||||||||||||||RRRR|||||||||||||||||||||||RRRR|||||||||||||||
|||||||||||||||RRRR|||||||||||||||||||||||RRRR|||||||||||||||||||||||RRRR|||||||||||||||
|||||||||||||||RRRR|||||||||||||||||||||||RRRR|||||||||||||||||||||||RRRR|||||||||||||||
|||||||||||||||RRRR|||||||||||||||||||||||RRRR|||||||||||||||||||||||RRRR|||||||||||||||
|||||||||||||||RRRR|||||||||||||||||||||||RRRR|||||||||||||||||||||||RRRR|||||||||||||||
|||||||||||||||RRRR|||||||||||||||||||||||RRRR|||||||||||||||||||||||RRRR|||||||||||||||
|||||||||||||||RRRR|||||||||||||||||||||||RRRR|||||||||||||||||||||||RRRR|||||||||||||||
|||||||||||||||RRRR|||||||||||||||||||||||RRRR|||||||||||||||||||||||RRRR|||||||||||||||
|||||||||||||||RRRR|||||||||||||||||||||||RRRR|||||||||||||||||||||||RRRR|||||||||||||||
|||||||||||||||RRRR|||||||||||||||||||||||RRRR|||||||||||||||||||||||RRRR|||||||||||||||
|||||||||||||||RRRR|||||||||||||||||||||||RRRR|||||||||||||||||||||||RRRR|||||||||||||||
|||||||||||||||RRRR|||||||||||||||||||||||RRRR|||||||||||||||||||||||RRRR|||||||||||||||
||||||||||RRRRRRRRRRRRR||||||||||||||RRRRRRRRRRRRRR||||||||||||||RRRRRRRRRRRRR||||||||||
||||||||||RRRRRRRRRRRRR||||||||||||||RRRRRRRRRRRRRR||||||||||||||RRRRRRRRRRRRR||||||||||
||||||||||RRRRRRRRRRRRR||||||||||||||RRRRRRRARRRRRR||||||||||||||RRRRRRRRRRRRR||||||||||
||||||||||RRRRRRRRRRRRR||||||||||||||RRRRRRRRRRRRRR||||||||||||||RRRRRRRRRRRRR||||||||||
||||||||||RRRRRRRARRRRR||||||||||||||RRRRRRRWRRRRRR||||||||||||||RRRRRRRRRRRRR||||||||||
||||||||||RRRRRRRRRRRRR||||||||||||||RRRRRRRRRRRRRR||||||||||||||RRRRRRRRRRRRR||||||||||
||||||||||RRRRRRRHRRRRR||||||||||||||RRRRRRR@RRRRRR||||||||||||||RRRRRRARRRRRR||||||||||
||||||||||RRRRRRRRRRRRR||||||||||||||RRRRRRRRRRRRRR||||||||||||||RRRRRRRRRRRRR||||||||||
||||||||||RRRRRRRRRRRRR||||||||||||||RRRRRRRRRRRRRR||||||||||||||RRRRRRRRRRRRR||||||||||
||||||||||RRRRRRRRRRRRR||||||||||||||RRRRRRRRRRRRRR||||||||||||||RRRRRRRRRRRRR||||||||||
||||||||||RRRRRRRRRRRRR||||||||||||||RRRRRRRRRRRRRR||||||||||||||RRRRRRRRRRRRR||||||||||
||||||||||RRRRRRRRRRRRR||||||||||||||RRRRRRRRRRRRRR||||||||||||||RRRRRRRRRRRRR||||||||||
||||||||||RRRRRRRRRRRRR||||||||||||||RRRRRRRRRRRRRR||||||||||||||RRRRRRRRRRRRR||||||||||
||||||||||||||||||||||||||||||||||||||||||||||||||||||||||||||||||||||||||||||||||||||||
||||||||||||||||||||||||||||||||||||||||||||||||||||||||||||||||||||||||||||||||||||||||
||||||||||||||||||||||||||||||||||||||||||||||||||||||||||||||||||||||||||||||||||||||||
||||||||||||||||||||||||||||||||||||||||||||||||||||||||||||||||||||||||||||||||||||||||
||||||||||||||||||||||||||||||||||||||||||||||||||||||||||||||||||||||||||||||||||||||||
||||||||||||||||||||||||||||||||||||||||||||||||||||||||||||||||||||||||||||||||||||||||