||||||||||||||||||||||||||||||||||||||||||||||||||||||||||||||||||||||||||||||||||||||||
||||||||||||||||||||||||||||||||||||||||||||||||||||||||||||||||||||||||||||||||||||||||
||||||||||||||||||||||||||||||||||||||||||||||||||||||||||||||||||||||||||||||||||||||||
||||||||||||||||||||||||||||||||||||||||||||||||||||||||||||||||||||||||||||||||||||||||
||||||||||||||||||||||||||||||||||||||||||||||||||||||||||||||||||||||||||||||||||||||||
||||||||||||||||||||||||||||||||||||||||||||||||||||||||||||||||||||||||||||||||||||||||
||||||||||.............||||||||||||||..............||||||||||||||.............||||||||||
||||||||||.............||||||||||||||..............||||||||||||||.............||||||||||
||||||||||.............||||||||||||||..............||||||||||||||.............||||||||||
||||||||||.............||||||||||||||..............||||||||||||||.............||||||||||
||||||||||.........................................||||||||||||||.............||||||||||
||||||||||.........................................||||||||||||||.............||||||||||
||||||||||.........................................||||||||||||||.............||||||||||
||||||||||.........................................||||||||||||||.............||||||||||
||||||||||.............||||||||||||||..............||||||||||||||.............||||||||||
||||||||||.............||||||||||||||..............||||||||||||||.............||||||||||
||||||||||.............||||||||||||||..............||||||||||||||.............||||||||||
||||||||||.............||||||||||||||..............||||||||||||||.............||||||||||
||||||||||.............||||||||||||||..............||||||||||||||.............||||||||||
|||||||||||||||....||||||||||||||||||||||||||||||||||||||||||||||||||....|||||||||||||||
|||||||||||||||....||||||||||||||||||||||||||||||||||||||||||||||||||....|||||||||||||||
|||||||||||||||....||||||||||||||||||||||||||||||||||||||||||||||||||....|||||||||||||||
|||||||||||||||....||||||||||||||||||||||||||||||||||||||||||||||||||....|||||||||||||||
|||||||||||||||....||||||||||||||||||||||||||||||||||||||||||||||||||....|||||||||||||||
|||||||||||||||....||||||||||||||||||||||||||||||||||||||||||||||||||....|||||||||||||||
|||||||||||||||....||||||||||||||||||||||||||||||||||||||||||||||||||....|||||||||||||||
|||||||||||||||....||||||||||||||||||||||||||||||||||||||||||||||||||....|||||||||||||||
|||||||||||||||....||||||||||||||||||||||||||||||||||||||||||||||||||....|||||||||||||||
|||||||||||||||....||||||||||||||||||||||||||||||||||||||||||||||||||....|||||||||||||||
|||||||||||||||....||||||||||||||||||||||||||||||||||||||||||||||||||....|||||||||||||||
|||||||||||||||....||||||||||||||||||||||||||||||||||||||||||||||||||....|||||||||||||||
|||||||||||||||....||||||||||||||||||||||||||||||||||||||||||||||||||....|||||||||||||||
|||||||||||||||....||||||||||||||||||||||||||||||||||||||||||||||||||....|||||||||||||||
||||||||||.............||||||||||||||..............||||||||||||||.............||||||||||
||||||||||.............||||||||||||||..............||||||||||||||.............||||||||||
||||||||||.............||||||||||||||..............||||||||||||||.............||||||||||
||||||||||.............||||||||||||||..............||||||||||||||.............||||||||||
||||||||||.............||||||||||||||..............||||||||||||||.............||||||||||
||||||||||..........................+..............+..........................||||||||||
||||||||||..........................+.......B......+..........................||||||||||
||||||||||..........................+..............+..........................||||||||||
||||||||||..........................+..............+..........................||||||||||
||||||||||.............||||||||||||||..............||||||||||||||.............||||||||||
||||||||||.............||||||||||||||..............||||||||||||||.............||||||||||
||||||||||.............||||||||||||||..............||||||||||||||.............||||||||||
||||||||||.............||||||||||||||..............||||||||||||||.............||||||||||
||||||||||.............||||||||||||||..............||||||||||||||.............||||||||||
|||||||||||||||....|||||||||||||||||||||||++++|||||||||||||||||||||||....|||||||||||||||
|||||||||||||||....|||||||||||||||||||||||....|||||||||||||||||||||||....|||||||||||||||
|||||||||||||||....|||||||||||||||||||||||....|||||||||||||||||||||||....|||||||||||||||
|||||||||||||||....|||||||||||||||||||||||....|||||||||||||||||||||||....|||||||||||||||
|||||||||||||||....|||||||||||||||||||||||....|||||||||||||||||||||||....|||||||||||||||
|||||||||||||||....|||||||||||||||||||||||....|||||||||||||||||||||||....|||||||||||||||
|||||||||||||||....|||||||||||||||||||||||....|||||||||||||||||||||||....|||||||||||||||
|||||||||||||||....|||||||||||||||||||||||....|||||||||||||||||||||||....|||||||||||||||
|||||||||||||||....|||||||||||||||||||||||....|||||||||||||||||||||||....|||||||||||||||
|||||||||||||||....|||||||||||||||||||||||....|||||||||||||||||||||||....|||||||||||||||
|||||||||||||||....|||||||||||||||||||||||....|||||||||||||||||||||||....|||||||||||||||
|||||||||||||||....|||||||||||||||||||||||....|||||||||||||||||||||||....|||||||||||||||
|||||||||||||||....|||||||||||||||||||||||....|||||||||||||||||||||||....|||||||||||||||
|||||||||||||||....|||||||||||||||||||||||....|||||||||||||||||||||||....|||||||||||||||
||||||||||.............||||||||||||||..............||||||||||||||.............||||||||||
||||||||||.............||||||||||||||..............||||||||||||||.............||||||||||
||||||||||.............||||||||||||||.......A......||||||||||||||.............||||||||||
||||||||||.............||||||||||||||..............||||||||||||||.............||||||||||
||||||||||......AAA....||||||||||||||WWWWWWWWWWWWWW||||||||||||||.............||||||||||
||||||||||.............||||||||||||||..............||||||||||||||.............||||||||||
||||||||||......HHH....||||||||||||||.......@......||||||||||||||......A......||||||||||
||||||||||.............||||||||||||||..............||||||||||||||.............||||||||||
||||||||||.............||||||||||||||..............||||||||||||||.............||||||||||
||||||||||.............||||||||||||||..............||||||||||||||.............||||||||||
||||||||||.............||||||||||||||..............||||||||||||||.............||||||||||
||||||||||.............||||||||||||||..............||||||||||||||.............||||||||||
||||||||||.............||||||||||||||..............||||||||||||||.............||||||||||
||||||||||||||||||||||||||||||||||||||||||||||||||||||||||||||||||||||||||||||||||||||||
||||||||||||||||||||||||||||||||||||||||||||||||||||||||||||||||||||||||||||||||||||||||
||||||||||||||||||||||||||||||||||||||||||||||||||||||||||||||||||||||||||||||||||||||||
||||||||||||||||||||||||||||||||||||||||||||||||||||||||||||||||||||||||||||||||||||||||
||||||||||||||||||||||||||||||||||||||||||||||||||||||||||||||||||||||||||||||||||||||||
||||||||||||||||||||||||||||||||||||||||||||||||||||||||||||||||||||||||||||||||||||||||