||||||||||||||||||||||||||||||||||||||||||||||||||||||||||||||||||||||
|.............||||||||||||||..............||||||||||||||.............|
|.............||||||||||||||..............||||||||||||||.............|
|.............||||||||||||||..............||||||||||||||.............|
|.............||||||||||||||..............||||||||||||||.............|
|.........................................||||||||||||||.............|
|.........................................||||||||||||||......#......|
|.........................................||||||||||||||.............|
|.........................................||||||||||||||.............|
|.............||||||||||||||..............||||||||||||||.............|
|.............||||||||||||||..............||||||||||||||.............|
|.............||||||||||||||..............||||||||||||||.............|
|.............||||||||||||||..............||||||||||||||.............|
|.............||||||||||||||..............||||||||||||||.............|
||||||....||||||||||||||||||||||||||||||||||||||||||||||||||....||||||
||||||....||||||||||||||||||||||||||||||||||||||||||||||||||....||||||
||||||....||||||||||||||||||||||||||||||||||||||||||||||||||....||||||
||||||....||||||||||||||||||||||||||||||||||||||||||||||||||....||||||
||||||....||||||||||||||||||||||||||||||||||||||||||||||||||....||||||
||||||....||||||||||||||||||||||||||||||||||||||||||||||||||....||||||
||||||....||||||||||||||||||||||||||||||||||||||||||||||||||....||||||
||||||....||||||||||||||||||||||||||||||||||||||||||||||||||....||||||
||||||....||||||||||||||||||||||||||||||||||||||||||||||||||....||||||
||||||....||||||||||||||||||||||||||||||||||||||||||||||||||....||||||
||||||....||||||||||||||||||||||||||||||||||||||||||||||||||....||||||
||||||....||||||||||||||||||||||||||||||||||||||||||||||||||....||||||
||||||....||||||||||||||||||||||||||||||||||||||||||||||||||....||||||
||||||....||||||||||||||||||||||||||||||||||||||||||||||||||....||||||
|.............||||||||||||||..............||||||||||||||.............|
|.............||||||||||||||..............||||||||||||||.............|
|.............||||||||||||||..............||||||||||||||.............|
|.............||||||||||||||..............||||||||||||||.............|
|.............||||||||||||||..............||||||||||||||.............|
|....................................................................|
|....................................................................|
|....................................................................|
|....................................................................|
|.............||||||||||||||..............||||||||||||||.............|
|.............||||||||||||||..............||||||||||||||.............|
|.............||||||||||||||..............||||||||||||||.............|
|.............||||||||||||||..............||||||||||||||.............|
|.............||||||||||||||..............||||||||||||||.............|
||||||....|||||||||||||||||||||||....|||||||||||||||||||||||....||||||
||||||....|||||||||||||||||||||||....|||||||||||||||||||||||....||||||
||||||....|||||||||||||||||||||||....|||||||||||||||||||||||....||||||
||||||....|||||||||||||||||||||||....|||||||||||||||||||||||....||||||
||||||....|||||||||||||||||||||||....|||||||||||||||||||||||....||||||
||||||....|||||||||||||||||||||||....|||||||||||||||||||||||....||||||
||||||....|||||||||||||||||||||||....|||||||||||||||||||||||....||||||
||||||....|||||||||||||||||||||||....|||||||||||||||||||||||....||||||
||||||....|||||||||||||||||||||||....|||||||||||||||||||||||....||||||
||||||....|||||||||||||||||||||||....|||||||||||||||||||||||....||||||
||||||....|||||||||||||||||||||||....|||||||||||||||||||||||....||||||
||||||....|||||||||||||||||||||||....|||||||||||||||||||||||....||||||
||||||....|||||||||||||||||||||||....|||||||||||||||||||||||....||||||
||||||....|||||||||||||||||||||||....|||||||||||||||||||||||....||||||
|.............||||||||||||||..............||||||||||||||.............|
|.............||||||||||||||..............||||||||||||||.............|
|.............||||||||||||||..............||||||||||||||.............|
|.............||||||||||||||..............||||||||||||||.............|
|.............||||||||||||||..............||||||||||||||.............|
|.............||||||||||||||..............||||||||||||||.............|
|.............||||||||||||||.......@......||||||||||||||.............|
|.............||||||||||||||..............||||||||||||||.............|
|.............||||||||||||||..............||||||||||||||.............|
|.............||||||||||||||..............||||||||||||||.............|
|.............||||||||||||||..............||||||||||||||.............|
|.............||||||||||||||..............||||||||||||||.............|
|.............||||||||||||||..............||||||||||||||.............|
||||||||||||||||||||||||||||||||||||||||||||||||||||||||||||||||||||||
