||||||||||||||||||||||||||||||||||||||||||||||||||||||||||||||||||||||||||||||||||
||||||||||||||||||||||||||||||||||||||||||||||||||||||||||||||||||||||||||||||||||
||||||||||||||||||||||||||||||||||||||||||||||||||||||||||||||||||||||||||||||||||
||||||||||||||||||||||||||||||||||||||||||||||||||||||||||||||||||||||||||||||||||
||||||||||||||||||||||||||||||||||||||||||||||||||||||||||||||||||||||||||||||||||
|||||||.............||||||||||||||..............||||||||||||||.............|||||||
|||||||.............||||||||||||||..............||||||||||||||.............|||||||
|||||||.............||||||||||||||..............||||||||||||||.............|||||||
|||||||.............||||||||||||||..............||||||||||||||.............|||||||
|||||||.........................................||||||||||||||.............|||||||
|||||||......W..................................||||||||||||||.............|||||||
|||||||.........................................||||||||||||||......#......|||||||
|||||||.........................................||||||||||||||.............|||||||
|||||||.............||||||||||||||..............||||||||||||||.............|||||||
|||||||.............||||||||||||||..............||||||||||||||.............|||||||
|||||||.............||||||||||||||..............||||||||||||||.............|||||||
|||||||.............||||||||||||||..............||||||||||||||.............|||||||
|||||||.............||||||||||||||..............||||||||||||||.............|||||||
||||||||||||....||||||||||||||||||||||||||||||||||||||||||||||||||....||||||||||||
||||||||||||....||||||||||||||||||||||||||||||||||||||||||||||||||....||||||||||||
||||||||||||....||||||||||||||||||||||||||||||||||||||||||||||||||....||||||||||||
||||||||||||....||||||||||||||||||||||||||||||||||||||||||||||||||....||||||||||||
||||||||||||....||||||||||||||||||||||||||||||||||||||||||||||||||....||||||||||||
||||||||||||....||||||||||||||||||||||||||||||||||||||||||||||||||....||||||||||||
||||||||||||....||||||||||||||||||||||||||||||||||||||||||||||||||....||||||||||||
||||||||||||....||||||||||||||||||||||||||||||||||||||||||||||||||....||||||||||||
||||||||||||....||||||||||||||||||||||||||||||||||||||||||||||||||....||||||||||||
||||||||||||....||||||||||||||||||||||||||||||||||||||||||||||||||....||||||||||||
||||||||||||....||||||||||||||||||||||||||||||||||||||||||||||||||....||||||||||||
||||||||||||....||||||||||||||||||||||||||||||||||||||||||||||||||....||||||||||||
||||||||||||....||||||||||||||||||||||||||||||||||||||||||||||||||....||||||||||||
||||||||||||....||||||||||||||||||||||||||||||||||||||||||||||||||....||||||||||||
|||||||.............||||||||||||||..............||||||||||||||.............|||||||
|||||||.............||||||||||||||..............||||||||||||||.............|||||||
|||||||.............||||||||||||||..............||||||||||||||.............|||||||
|||||||.............||||||||||||||..............||||||||||||||.............|||||||
|||||||.............||||||||||||||..............||||||||||||||.............|||||||
|||||||....................................................................|||||||
|||||||....................................................................|||||||
|||||||....................................................................|||||||
|||||||....................................................................|||||||
|||||||.............||||||||||||||..............||||||||||||||.............|||||||
|||||||.............||||||||||||||..............||||||||||||||.............|||||||
|||||||.............||||||||||||||..............||||||||||||||.............|||||||
|||||||.............||||||||||||||..............||||||||||||||.............|||||||
|||||||.............||||||||||||||..............||||||||||||||.............|||||||
||||||||||||....|||||||||||||||||||||||....|||||||||||||||||||||||....||||||||||||
||||||||||||....|||||||||||||||||||||||....|||||||||||||||||||||||....||||||||||||
||||||||||||....|||||||||||||||||||||||....|||||||||||||||||||||||....||||||||||||
||||||||||||....|||||||||||||||||||||||....|||||||||||||||||||||||....||||||||||||
||||||||||||....|||||||||||||||||||||||....|||||||||||||||||||||||....||||||||||||
||||||||||||....|||||||||||||||||||||||....|||||||||||||||||||||||....||||||||||||
||||||||||||....|||||||||||||||||||||||....|||||||||||||||||||||||....||||||||||||
||||||||||||....|||||||||||||||||||||||....|||||||||||||||||||||||....||||||||||||
||||||||||||....|||||||||||||||||||||||....|||||||||||||||||||||||....||||||||||||
||||||||||||....|||||||||||||||||||||||....|||||||||||||||||||||||....||||||||||||
||||||||||||....|||||||||||||||||||||||....|||||||||||||||||||||||....||||||||||||
||||||||||||....|||||||||||||||||||||||....|||||||||||||||||||||||....||||||||||||
||||||||||||....|||||||||||||||||||||||....|||||||||||||||||||||||....||||||||||||
||||||||||||....|||||||||||||||||||||||....|||||||||||||||||||||||....||||||||||||
|||||||.............||||||||||||||..............||||||||||||||.............|||||||
|||||||.............||||||||||||||..............||||||||||||||.............|||||||
|||||||.............||||||||||||||.......A......||||||||||||||.............|||||||
|||||||.............||||||||||||||..............||||||||||||||.............|||||||
|||||||......A......||||||||||||||.......W......||||||||||||||.............|||||||
|||||||.............||||||||||||||..............||||||||||||||.............|||||||
|||||||......H......||||||||||||||.......@......||||||||||||||......A......|||||||
|||||||.............||||||||||||||..............||||||||||||||.............|||||||
|||||||.............||||||||||||||..............||||||||||||||.............|||||||
|||||||.............||||||||||||||..............||||||||||||||.............|||||||
|||||||.............||||||||||||||..............||||||||||||||.............|||||||
|||||||.............||||||||||||||..............||||||||||||||.............|||||||
|||||||.............||||||||||||||..............||||||||||||||.............|||||||
||||||||||||||||||||||||||||||||||||||||||||||||||||||||||||||||||||||||||||||||||
||||||||||||||||||||||||||||||||||||||||||||||||||||||||||||||||||||||||||||||||||
||||||||||||||||||||||||||||||||||||||||||||||||||||||||||||||||||||||||||||||||||
||||||||||||||||||||||||||||||||||||||||||||||||||||||||||||||||||||||||||||||||||
||||||||||||||||||||||||||||||||||||||||||||||||||||||||||||||||||||||||||||||||||
