||||||||||||||||||||||||||||||||||||||
||||||||||||||||||||||||||||||||||||||
||||||||||||||||||||||||||||||||||||||
||||||||||||||||||||||||||||||||||||||
||||||||||||||||||||||||||||||||||||||
||||||||||||||||||||||||||||||||||||||
||||||||||..................||||||||||
||||||||||..................||||||||||
||||||||||..................||||||||||
||||||||||..................||||||||||
||||||||||........B.........||||||||||
||||||||||..................||||||||||
||||||||||..................||||||||||
||||||||||..................||||||||||
||||||||||..................||||||||||
||||||||||..................||||||||||
||||||||||..................||||||||||
||||||||||..................||||||||||
|||||||||||||||||++++|||||||||||||||||
|||||||||||||||||....|||||||||||||||||
|||||||||||||||||....|||||||||||||||||
|||||||||||||||||....|||||||||||||||||
|||||||||||||||||....|||||||||||||||||
|||||||||||||||||....|||||||||||||||||
|||||||||||||||||....|||||||||||||||||
|||||||||||||||||....|||||||||||||||||
|||||||||||||||||....|||||||||||||||||
|||||||||||||||||....|||||||||||||||||
|||||||||||||||||....|||||||||||||||||
|||||||||||||||||....|||||||||||||||||
|||||||||||||||||....|||||||||||||||||
|||||||||||||||||....|||||||||||||||||
|||||||||||||||||....|||||||||||||||||
|||||||||||||||||....|||||||||||||||||
|||||||||||||||||....|||||||||||||||||
|||||||||||||||||....|||||||||||||||||
|||||||||||||||||....|||||||||||||||||
|||||||||||||||||....|||||||||||||||||
|||||||||||||||||....|||||||||||||||||
|||||||||||||||||....|||||||||||||||||
|||||||||||||||||....|||||||||||||||||
|||||||||||||||||....|||||||||||||||||
|||||||||||||||||....|||||||||||||||||
|||||||||||||||||....|||||||||||||||||
|||||||||||||||||....|||||||||||||||||
|||||||||||||||||....|||||||||||||||||
|||||||||||||||||....|||||||||||||||||
|||||||||||||||||....|||||||||||||||||
|||||||||||||||||....|||||||||||||||||
|||||||||||||||||....|||||||||||||||||
|||||||||||||||||....|||||||||||||||||
|||||||||||||||||....|||||||||||||||||
||||||||||..................||||||||||
||||||||||.AA.H...W....H.AA.||||||||||
||||||||||.......WWW........||||||||||
||||||||||........W.........||||||||||
||||||||||........W.........||||||||||
||||||||||........@.........||||||||||
||||||||||..................||||||||||
||||||||||..................||||||||||
||||||||||..................||||||||||
||||||||||..................||||||||||
||||||||||..................||||||||||
||||||||||..................||||||||||
||||||||||||||||||||||||||||||||||||||
||||||||||||||||||||||||||||||||||||||
||||||||||||||||||||||||||||||||||||||
||||||||||||||||||||||||||||||||||||||
||||||||||||||||||||||||||||||||||||||
||||||||||||||||||||||||||||||||||||||
