||||||||||||||||||||||||||||||||||||||||||||#
|||||||||||||||||||||||||||||||||||||||||||||
|||||||||||||||||||||||||||||||||||||||||||||
|||||||||||||||||||||||||||||||||||||||||||||
|||||||||||||||||||||||||||||||||||||||||||||
|||||||||||||||||||||||||||||||||||||||||||||
|||||||||||||||||||||||||||||||||||||||||||||
||||||||||RRRRRRRRRRRRRRRRRRRRRRRRR||||||||||
||||||||||RRRRRRRRRRRRRRRRRRRRRRRRR||||||||||
||||||||||RRRRRRRRRRRRRRRRRRRRRRRRR||||||||||
||||||||||RRRRRRRRRRRRRRRRRRRRRRRRR||||||||||
||||||||||RRRRR...............RRRRR||||||||||
||||||||||RRRRR...............RRRRR||||||||||
||||||||||RRRRR...............RRRRR||||||||||
||||||||||RRRRR...............RRRRR||||||||||
||||||||||RRRRR...............RRRRR||||||||||
||||||||||RRRRR...............RRRRR||||||||||
||||||||||RRRRR.......@.......RRRRR||||||||||
||||||||||RRRRR...............RRRRR||||||||||
||||||||||RRRRR...............RRRRR||||||||||
||||||||||RRRRR...............RRRRR||||||||||
||||||||||RRRRR...............RRRRR||||||||||
||||||||||RRRRR...............RRRRR||||||||||
||||||||||RRRRRRRRRRRRRRRRRRRRRRRRR||||||||||
||||||||||RRRRRRRRRRRRRRRRRRRRRRRRR||||||||||
||||||||||RRRRRRRRRRRRRRRRRRRRRRRRR||||||||||
||||||||||RRRRRRRRRRRRRRRRRRRRRRRRR||||||||||
|||||||||||||||||||||||||||||||||||||||||||||
|||||||||||||||||||||||||||||||||||||||||||||
|||||||||||||||||||||||||||||||||||||||||||||
|||||||||||||||||||||||||||||||||||||||||||||
|||||||||||||||||||||||||||||||||||||||||||||
|||||||||||||||||||||||||||||||||||||||||||||

